NO ./path_to_the_north_texture
SO ./path_to_the_south_texture
WE ./path_to_the_west_texture
EA ./path_to_the_east_texture

F 90,90,90
C 50,153,204

11111111111111111111111111111111111111111111111
10000000000000000011110000000000000000000000001
10000000000000001010001100000000000000000000001
10000000011110111010000110000000000000000000001
10011000010010100010000010000111110000011110001
11110111110010110100000010000000001000011001001
10000000000010010101000010011100001000001001001
10N00000000010010101000100010100001000000100101
10000000111100010111000100010000001000000100101
10000001100000010000000111110000001110001100101
10000001000000010000000000000000000011111001101
10000001111111110000000000000000000000000001111
10000000000000000000000000000000000000000000001
11111111111111111111111111111111111111111111111