NO ./path_to_the_north_texture
SO ./path_to_the_south_texture
WE ./path_to_the_west_texture
EA ./path_to_the_east_texture

F 117, 142, 79
C 135, 245, 251

111111
100101
1010001
1100N1
111111