NO ./path_to_the_north_texture
SO ./path_to_the_south_texture
WE ./path_to_the_west_texture
EA ./path_to_the_east_texture

F 117, 142, 79
C 135, 245, 251

1111111111
1000N00001
1111000001
1000000001
100011101
1000001001
100000100111111111
111111100000000001
      100000000001
      100000000001
      100001110111
      100001000001
      100001000001
      111111111111