NO ./path_to_the_north_texture
SO ./path_to_the_south_texture
WE ./path_to_the_west_texture
EA ./path_to_the_east_texture

F 220,100,0
C 225,30,0
                            11
111111111111111111111111111101
10000000000000000000000000011
1000011100000111000011000001
10000111000001110001001000001
1000000000000000000000000001
1000000000000000000000000001
1000000000000000000000000001
1000000000000000000000000001
1000000000000000000000000001
1000000000000000000000000001
1000000000000000000000000001
10000000N0000000000000000001
1000000000000000000000000001
1111111111111111111111111111
