NO ./path_to_the_north_texture
SO ./path_to_the_south_texture
WE ./path_to_the_west_texture
EA ./path_to_the_east_texture

F 220,100,0
C 225,30,0

1111111111111111111111111111
1000000000110000000000001111
1011000001110000000000001111
1001000000000011111111111111
1111111110000000011100001111
1000000000000000011100001111
1111000000000000000000000001
1111000000000000000000000001
1000000000000011111111111111
1000000000000000000000000001
100000000000N0000000000000111
100000011100000111000000000001
10000001 1000001 1000000000001
11111111 1111111 1111111111111
